C 111,111,112
F 222,222,222

NO ./textures/download-1.xpm                         
SO ./textures/download-2.xpm
WE ./textures/images.xpm
EA ./textures/download.xpm




11111111111111111111111111111111       11111
		1000000000110000000000001      101
		1011000001110000000000001       1
		1001000000000000000000011       1
11111111111111110110000011100001						   
100000000011000001110111111111111
11110111111111001100000010001		 11   
11110111111111011101010010001		 101
11000000110101011100000010001		  1
10000000000000000110000001001
10000000000000000110000001001
10000000000000000110000001001
1000000001N0000011010100100011
10000000000000000110000001001
10000000000000000110000001001
10000000000000000110000001001
110000011001010111110111100111
11110111 1110101 101111010001
11111111 1111111 111111111111







